####################
#                  #
# ################ #
# #              # #
# # ############ # #
# # #          # # #
# # # ######## # # #
# # # #G       # # #
# # # ########## # #
# # #            # #
# # ############## #
# #                #
# ##################
#                 S#
####################