####################
#G                 #
################## #
#                  #
# ##################
#                  #
################## #
#                  #
# ##################
#                  #
################## #
#                  #
# ##################
#                 S#
####################