####################
#G                 #
################## #
###                #
### ################
###              ###
################ ###
####             ###
#### ###############
####            ####
############### ####
#####           ####
##### ##############
#####         S#####
####################